11111111
10000111
111E0111
101PC111
11111111