111111111111111111
100001111111000E11
1C11011C0C00010111
1010011CC111110111
101C00000111110111
100011111000010111
111P1111101100C111
1110000C001110C111
111111111111111111