111111111111111111
1C0000011110000001
100110000010111001
11111000P0001111E1
1C0111000011100C11
100000001000000011
111111111111111111
