11111111111111111111111
1CCCCCCCCCCCCCCCCCCCCC1
1CCCCCCCCCCCCCCCCCCCCC1
1CCCCCCCCCCCCCCCCCCCCC1
1CCCCCCCCC000CCCCCCCCC1
1CCCCCCCCC0E0CCCCCCCCC1
1CCCCCCCCC000CCCCCCCCC1
1CCCCCCCCCCCCCCCCCCCCC1
1CCCCCCCCCCCCCCCCCCCCC1
1PCCCCCCCCCCCCCCCCCCCC1
11111111111111111111111
