11111111111111111111111
11000000000000C00E11111
11011111111111111111111
1100000P111111110011111
11110111111111000111111
11110111111111011110011
111100000000000111100C1
11111111111111111111111