11111111111111
1CCC000000CCC1
1CCC000000CCC1
1CCC000000CCC1
10000000000001
100000PE000001
10000000000001
1CCC000000CCC1
1CBC000000CCC1
1CCC000000CCC1
11111111111111